111111111111111111111111111111
100000001000000C00000C00000001
100101011010000010100100010101
100101001010101000101100010101
1P0000001C00C00000E010000000C1
111111111111111111111111111111